F 64,66,88
WE ./textures/night2.xpm
EA ./textures/night4.xpm
SO ./textures/night3.xpm
NO ./textures/night.xpm 



C 6,59,100

11111111111111111111111111111
1000000000000N0000000000000001
1011000001110000000000000000001
1001000000000000000000000000000111111
1111111110110000011100000000000000001
10000000001100000111000000000000000001
111101111111110000000010000000000000001
1111011111111100000101001000000000000011
110000001101010111000000100000000000001
10000000000000001100000010001111111111
10000000000000001101010000001
1100000111010101100000011111          11111111                       
11110111 1110101 101111010001          10000001
11111111 1111111 111111111111          11111111